9	6	6	6	26	6	6	6	28	28	28	6	6	6	6	12
28	4	4	4	4	4	4	4	4	4	4	9	5	5	5	12
28	4	4	4	4	4	4	4	4	4	4	21	5	5	5	12
9	6	6	6	23	6	6	12	4	4	4	9	5	5	5	12
9	3	3	3	3	3	3	12	4	4	4	7	6	28	6	12
9	3	3	3	3	3	3	28	4	4	4	4	4	4	4	12
9	3	3	3	3	3	3	28	4	4	4	4	4	4	4	12
9	6	28	6	20	6	6	12	4	4	8	13	28	28	13	12
9	3	3	3	3	3	3	12	4	4	9	0	0	0	0	12
9	3	3	3	3	3	3	28	4	4	15	0	0	0	0	12
9	3	3	3	3	3	3	12	4	4	9	0	0	0	0	12
7	6	6	6	6	6	6	6	6	6	6	6	17	6	6	10
