8	13	13	13	13	13	13	13	13	13	13	13	13	13	13	11
9	0	0	0	0	0	0	0	0	0	0	0	0	0	0	12
9	0	0	0	0	0	0	0	0	0	0	0	0	0	0	12
9	0	0	0	0	0	0	0	0	0	0	0	0	0	0	12
9	0	0	0	0	0	0	0	0	0	0	0	0	0	0	12
9	0	0	0	0	0	0	0	0	0	0	0	0	0	0	12
9	0	0	0	0	0	0	0	0	0	0	0	0	0	0	12
9	0	0	0	0	0	0	0	0	0	0	0	0	0	0	12
24	0	0	0	0	0	0	0	0	0	0	0	0	0	0	12
9	0	0	0	0	0	0	0	0	0	0	0	0	0	0	12
9	0	0	0	0	0	0	0	0	0	0	0	0	0	0	12
7	6	6	6	6	6	6	6	6	6	6	6	6	6	6	10
