8	13	13	13	13	13	13	13	13	13	13	13	13	13	13	11
9	4	4	12	0	0	0	22	3	3	3	3	3	3	3	12
9	4	4	12	0	0	0	12	3	3	3	3	3	3	3	12
28	4	4	8	13	13	13	11	3	3	3	3	3	3	3	12
28	4	4	15	5	5	5	12	3	3	3	3	3	3	3	12
9	4	4	9	5	5	5	22	3	3	3	3	3	3	3	12
9	4	4	7	6	23	6	10	6	6	6	28	28	6	6	12
9	4	4	4	4	4	4	4	4	4	4	4	4	4	4	19
9	4	4	4	4	4	4	4	4	4	8	13	13	13	13	12
9	28	28	13	11	4	4	4	4	4	9	2	2	2	2	12
9	1	1	1	22	4	4	4	4	4	4	2	2	2	2	28
7	6	6	6	6	6	28	28	6	6	6	6	6	6	6	10
