0	0	0	0	0	0	0	9	6	6	6	6	30	6	6	12
0	0	0	0	0	0	0	9	4	4	4	4	4	4	4	12
0	0	0	0	0	0	0	9	4	5	5	5	5	5	4	28
0	0	0	0	0	0	0	24	4	5	5	5	5	5	4	28
0	0	0	0	0	0	0	9	4	5	5	5	5	5	4	28
0	0	0	0	0	0	0	9	4	4	4	4	4	4	4	12
0	1	0	0	1	0	0	7	6	6	28	28	28	6	6	10
0	1	0	0	1	0	0	0	0	0	0	0	0	0	0	0
0	1	1	1	1	0	0	0	0	0	0	0	0	0	0	0
0	1	0	0	1	0	0	0	0	0	0	0	0	0	0	0
0	1	0	0	1	0	0	0	0	0	0	0	0	0	0	0
0	0	0	0	0	0	0	0	0	0	0	0	0	0	0	0
