8	13	13	13	13	13	13	13	13	13	13	13	13	13	13	11
9	5	5	5	5	5	5	12	3	3	3	3	3	3	3	12
9	5	5	5	5	5	5	12	3	3	3	3	3	3	3	16
28	5	5	5	5	5	5	12	3	3	3	3	3	3	3	12
28	5	5	5	5	5	5	12	3	3	3	3	3	3	3	12
9	5	5	5	5	5	5	27	3	3	3	3	3	3	3	12
9	6	6	6	6	23	6	10	6	6	6	28	28	6	6	12
18	4	4	4	4	4	4	4	4	4	4	4	4	4	4	12
9	4	4	4	4	4	4	4	4	4	4	4	4	4	4	12
9	4	4	4	4	4	4	4	4	4	4	4	4	4	4	12
9	4	4	4	4	4	4	4	4	4	4	4	4	4	4	12
7	6	6	6	6	6	6	6	6	6	6	6	6	6	6	10
