8	13	13	13	13	13	13	13	13	13	13	13	13	13	13	11
9	5	5	5	12	4	4	12	3	3	3	3	21	4	4	12
28	5	5	5	22	4	4	12	3	3	3	3	7	6	6	12
28	5	5	5	12	4	4	12	3	3	3	3	3	3	3	16
9	6	6	6	10	4	4	12	3	3	3	3	3	3	3	12
9	4	4	4	4	4	4	19	3	3	3	3	3	3	3	12
9	6	6	6	6	23	6	10	6	6	6	28	28	6	6	12
18	4	4	4	4	4	4	21	4	4	4	4	4	4	4	12
9	13	13	28	28	13	13	13	4	4	4	4	4	4	4	12
0	0	0	0	0	0	0	28	4	4	4	4	4	4	4	12
0	0	0	0	0	0	0	9	4	4	4	4	4	4	4	12
0	0	0	0	0	0	0	7	6	6	6	28	28	6	6	10
