9	6	6	6	6	6	6	6	6	6	6	6	17	6	6	12
9	3	3	3	3	3	28	1	1	1	1	1	0	1	1	12
15	3	3	3	3	3	28	1	0	0	0	0	0	0	1	12
9	3	3	3	3	3	12	1	1	1	1	1	1	0	1	12
9	6	6	23	6	6	10	13	13	13	13	11	1	0	1	12
9	3	1	0	1	3	9	5	5	5	5	12	1	0	1	12
9	3	1	0	1	3	9	5	5	5	5	12	1	0	1	12
9	3	1	0	1	3	9	5	5	5	5	12	1	0	1	12
9	3	1	0	1	3	7	6	20	6	6	10	1	0	1	12
9	3	1	0	1	1	1	1	0	1	1	1	1	0	1	12
9	3	1	0	0	0	0	0	0	0	0	0	0	0	1	12
7	6	6	6	6	6	6	6	6	6	6	6	6	6	6	10
