0	0	0	0	0	0	0	0	0	0	0	0	0	0	0	0
0	0	0	0	0	0	0	0	0	0	0	0	0	0	0	0
9	6	6	6	6	28	28	28	6	6	6	6	6	6	6	12
9	1	1	1	1	1	1	1	1	1	1	1	1	1	1	12
28	0	0	0	0	0	0	0	0	0	0	0	0	0	1	12
9	0	1	1	0	1	1	1	1	1	1	1	1	0	1	12
9	0	1	1	0	1	8	13	13	13	13	11	1	0	1	12
9	14	12	1	0	1	9	3	3	3	3	12	1	0	1	12
9	4	12	1	0	1	18	3	3	3	3	12	1	0	0	25
9	4	12	1	0	1	9	3	3	3	3	12	1	0	1	12
9	4	12	1	0	1	9	3	3	3	3	12	1	0	1	12
7	6	6	6	30	6	6	6	28	28	28	6	6	6	6	10
