8	13	28	28	13	13	13	13	13	13	28	28	28	13	13	11
9	4	4	4	4	12	1	1	1	1	1	1	1	1	1	12
9	4	4	4	4	16	0	0	0	0	0	0	0	0	0	25
9	4	4	4	4	12	0	0	0	0	0	0	0	0	0	12
9	4	4	4	4	12	0	0	1	1	1	1	1	1	1	12
9	6	28	28	6	10	0	0	8	13	13	28	28	13	13	12
9	1	1	1	1	1	0	0	9	3	3	3	3	3	3	12
9	0	0	0	0	0	0	0	28	3	3	3	3	3	3	12
29	0	0	0	0	0	0	0	9	3	3	3	3	3	3	12
7	6	6	6	6	6	0	0	21	3	3	3	3	3	3	12
0	0	0	0	0	9	0	0	9	3	3	3	3	3	3	12
0	0	0	0	0	7	6	6	6	6	6	6	6	6	6	10
