9	6	6	6	6	6	6	6	6	6	6	6	17	6	6	12
9	1	1	1	1	1	1	1	9	2	2	2	2	2	2	12
24	0	0	0	0	0	0	0	9	2	2	2	2	2	2	12
9	0	0	0	0	0	0	0	15	2	2	2	2	2	2	12
9	1	1	1	1	1	0	1	9	2	2	2	2	2	2	12
9	6	6	6	6	6	20	6	6	6	6	28	28	6	6	10
9	5	5	5	12	4	4	4	9	0	0	0	0	0	0	0
9	5	5	5	12	4	4	4	28	0	0	0	0	0	0	0
9	5	5	5	22	4	4	4	28	0	0	0	0	0	0	0
9	5	5	5	12	4	4	4	28	0	0	0	0	0	0	0
9	5	5	5	12	4	4	4	9	0	0	0	0	0	0	0
7	6	28	28	28	28	6	6	6	0	0	0	0	0	0	0
