8	13	13	13	13	28	13	13	13	13	28	28	28	13	13	11
9	5	5	12	1	0	1	9	4	4	4	4	4	4	4	12
9	5	5	22	0	0	0	18	4	5	5	5	5	5	4	25
9	5	5	12	1	0	1	9	4	4	4	4	4	4	4	12
9	6	6	10	1	0	1	7	6	6	6	6	6	6	6	10
9	1	1	1	1	0	1	1	1	1	1	1	1	1	12	0
28	0	0	0	0	0	0	0	0	0	0	0	0	1	28	0
9	1	1	1	1	1	1	1	1	1	1	1	0	1	28	0
9	13	13	13	28	28	28	13	13	13	11	1	0	1	28	0
0	0	0	9	3	3	3	3	3	3	12	1	0	1	12	0
0	0	0	28	3	3	3	3	3	3	16	1	0	1	12	0
0	0	0	7	6	6	6	6	6	6	6	6	17	6	10	0
