8	13	13	13	13	28	13	13	13	13	28	28	28	13	13	11
9	4	4	4	4	4	4	4	4	4	4	4	4	4	4	12
24	5	5	5	5	5	5	5	5	5	5	5	5	5	4	28
9	4	4	4	4	4	4	4	4	4	4	4	5	5	4	28
9	6	6	6	6	6	6	6	6	20	12	4	5	5	4	28
9	2	2	2	2	2	2	12	1	0	12	4	5	5	4	12
9	2	2	2	2	2	2	22	0	0	12	6	6	14	6	12
9	2	2	2	2	2	2	12	1	0	12	4	5	5	4	12
9	13	28	13	13	28	13	13	28	28	12	4	5	5	4	12
0	0	0	0	0	0	0	0	0	0	12	4	5	5	4	12
0	0	0	0	0	0	0	0	0	0	12	4	5	5	4	12
0	0	0	0	0	0	0	0	0	0	6	6	6	17	6	10
