1 2 2 2 1 1 1 1 1 1 1 1 1 1 1 1
1 1 1 0 0 0 0 0 0 0 0 0 0 0 0 0
1 1 1 0 0 0 0 0 0 0 0 0 0 0 0 0
1 0 8 13 13 13 11 0 0 0 0 0 0 0 0 0
1 0 24 5 5 5 12 0 0 1 1 0 0 0 3 3
1 0 9 5 5 5 22 0 0 1 1 0 0 0 3 3
1 0 7 6 26 6 10 0 0 0 0 0 0 0 0 0
1 0 0 0 0 4 4 4 0 0 0 0 0 0 0 0
1 0 0 0 0 4 4 4 0 0 0 0 0 0 0 0
1 0 0 0 0 0 0 0 0 0 0 0 0 0 0 0
1 0 0 0 0 0 0 0 0 0 2 2 0 0 0 0
1 0 0 0 0 0 0 0 0 0 2 2 0 0 0 0