8 13 13 13 13 13 13 13 13 13 13 13 13 13 13 11
9 1 1 0 0 0 0 0 0 0 0 0 0 0 0 12
9 1 1 0 0 0 0 0 0 0 0 0 0 0 0 12
9 0 8 13 13 13 11 0 0 0 0 0 0 0 0 12
9 0 15 5 5 5 12 0 0 1 1 0 0 0 3 12
9 0 9 5 5 5 22 0 0 1 1 0 0 0 3 12
9 0 7 6 23 6 10 0 0 0 0 0 0 0 0 12
9 0 0 0 0 4 4 4 0 0 0 0 0 0 0 12
9 0 0 0 0 4 4 4 0 0 0 0 0 0 0 12
9 0 0 0 0 0 0 0 0 0 0 0 0 0 0 12
9 0 0 0 0 0 0 0 0 0 2 2 0 0 0 12
7 6 6 6 6 6 6 6 6 6 6 6 6 6 6 10